NO ./images/north.xpm
SO ./images/south.xpm
WE ./images/west.xpm
EA ./images/east.xpm

F 220,100,0
C 225,30,0

11111
10001
10001
10001
11111
        1111111111111111111111111
        1000000000110000000000001
        1011000001110000000000001
        1001000000000000000000001
111111111011000001110000000000001
100000000011000000010111111111111
11110111111101111100000010001
11110111111101   101010010001
11000000110101   100000010001
10000000000001   10000N010001
10000000000001111101010010001
11000001110100000001111000111
11110111 11101011101111010001
11111111 1111111 111111111111
