NO ./images/wall1.xpm
SO ./images/wall2.xpm
WE ./images/wall3.xpm
EA ./images/wall4.xpm
D  ./images/door.xpm
O  ./images/sprite1.xpm
O  ./images/sprite2.xpm
O  ./images/sprite3.xpm

F 129,193,71
C 0,191,255

11111
10101
11011
10101
11111
        1111111111111111111111111
        1000000000110000000000001
        1011000001110000000000001
        1001000000000000000000001
111111111011000001110000000000001
100000000011000000000111111111111
111101111111001111100000010001
1111D1111111101   101010010001
110000000110101   100000010001
1000000O0000001   100000010001
1000N000000000111110010010001
11000001110100000001111000111
11110111 11101011101111010001
11111111 1111111 111111111111
