NO ./images/wall1.xpm
SO ./images/wall2.xpm
WE ./images/wall3.xpm
EA ./images/wall4.xpm

F 129,193,7
C 0,191,255

11111111111111111111111111111111111111111111111111111
10000000001000011000000000000000000000000100000000001
10000000001000011000000011111111100000000100000000001
1000010000100000100000001       100000000111111100001
1000011111100000000000001       100000000000000000001
1000000000000001110000001       100000000000000000001
10000000000000011100000011111111100000000111111100001
1111111111100000N000000000000000000000011111110000001
10000000000000000000000000000000000001111111110000001
10010000010000000000001111111111000111111100000000001
10010000010000011000001100000000000000000000000000001
10011111110000011000001100000110000000000111000000001
10011000000000000000001100000110000000000111000000001
10011000000000000000001100000110000000000111000000001
11111111111111111111111111111111111111111111111111111
